NO ./assets/wall1.xpm
SO ./assets/wall2.xpm
WE ./assets/wall3.xpm
EA ./assets/wall4.xpm

C 124,159,12
F 255,255,203

1111111111111111111111111
1000000000000100000000001
1000000000000000000000001
1000011000000000000000001
1100000000000000000000001
1100000000000000000000011
1100000000000010000000011
1000000000000000000000001
100000S000000000000000001
1000000000000000000000001
1000001111111000000000001
1111111111111111111111111